0000000000000000000000000000000000000000000000000000000000000000000000000000000000000000000000000000000000002111111100000000000000000000000000000000000000000000000000000000000000000000000000000000000000000000000000000000009
0000000000000000000000000000000000000000000000000000000000000000000000000000000000000000000000000000000000003111111100000000000000000000000000000000000000000000000000000000000000000000000000000000000000000000000000000000009
0000000000000000000000000000000000000000000000000000000000000000000000000000000000000000000000000000000000003111111100000000000000000000000000000000000000000000000000000000000000000000000000000000000000000000000000000000009
0000000000000000000000000000000000000000000000000000000000000000000000000000000000000000000000000000000000003111111100000000000000000000000000000000000000000000000000000000000000000000000000000000000000000000000000000000009
0000000000000000000000000000000000000000000000000000000000002111110000000000000000000000000000000000000000003111111100000000000000000000000000000000000000000000000000211111000000000000000000000000000000000000000000000000009
0000000000000000000000000000000000000000000000000000000000003111110000000000000000000000000000000000000000003111111100000000000000000000000000000000000000000000000000311111000000000000000000000000000000000000000000000000009
000000000000000000000000000000000000000000000000dddddd0000003111110000000000000000000000000000000000000000003111111100000000000000000000000000000000000000000000000000311111000000bbbbbb000000000000000000000000000000000000009
000000000000000000000000000000000000000000000000dddddd0000003111110000000000000000000000000000000000000000000000000000000000000000000000000000000000000000000000000000311111000000bbbbbb000000000000000000000000000000000000009
000000000000000000000000000000000000000000000000dddddd0000003111110000000000000000000000000000000000000000000000000000000000000000000000000000000000000000000000000000311111000000bbbbbb000000000000000000000000000000000000009
000000000000000000000000000000000000000000000000dddddd0000003111110000000000000000000000000000000000000000000000000000000000000000000000000000000000000000000000000000311111000000bbbbbb000000000000000000000000000000000000009
0000000000000000000000000000000000000000000211111111111111111111110000000000000000000000000000000000000000000000000000000000000000000000000000000000000000000000000000211111111111111111111110000000000000000000000000000000009
0000000000000000000000000000000000000000000311111111111111111111110000000000000000000000000000000000000000000000000000000000000000000000000000000000000000000000000000311111111111111111111110000000000000000000000000000000009
0000000000000000000000000000000000000000000311111111111111111111110000000000000000000000000000000000000000000211111000000000000000000000000000000000000000000000000000311111111111111111111110000000000000000000000000000000009
0000000000000000000000000000000000000000000000000000000000000000000000000000000000000000000000000000000000000311111000000000000000000000000000000000000000000000000000000000000000000000000000000000000000000000000000000000009
0000000000000000000000000000000000000000000000000000000000000000000000000000000000000000000000000000000000000311111000000000000000000000000000000000000000000000000000000000000000000000000000000000000000000000000000000000009
0000000000000000000000000000000000000000000000000000000000000000000000000000000000000000000000000000000000000311111000000000000000000000000000000000000000000000000000000000000000000000000000000000000000000000000000000000009
0000000000000000000000000000000000000000000000000000000000000000000000000000000000000000000000000000000000000311111000000000000000000000000000000000000000000000000000000000000000000000000000000000000000000000000000000000009
0000000000000000000000000000000000000000000000000000000000000000000000000000000000000000000000000000000000000311111000000000000000000000000000000000000000000000000000000000000000000000000000000000000000000000000000000000009
2111111111111111110000000000000000000000000000000000000000000000000000000000000000000000211111111111111111111111111111111111111111111111000000000000000000000000000000000000000000000000000000000000000000002111111111111111119
3111111111111111110000000000000000000000000000000000000000000000000000000000000000000000311111111111111111111111111111111111111111111111000000000000000000000000000000000000000000000000000000000000000000003111111111111111119
0000000000000000000000000000000000000000000000000000000000000000000000000000000000000000000000000000000000000211111000000000000000000000000000000000000000000000000000000000000000000000000000000000000000000000000000000000009
0000000000000000000000000000000000000000000000000000000000000000000000000000000000000000000000000000000000000311111000000000000000000000000000000000000000000000000000000000000000000000000000000000000000000000000000000000009
0000000000000000000000000000000000000000000000000000000000000000000000000000000000000000000000000000000000000311111000000000000000000000000000000000000000000000000000000000000000000000000000000000000000000000000000000000009
0000000000000000000000000000000000000000000000000000000000000000000000000000000000000000000000000000000000000311111000000000000000000000000000000000000000000000000000000000000000000000000000000000000000000000000000000000009
0000000000000000000000000000000000000000000000000000000000000000000000000000000000000000000000000000000000000311111000000000000000000000000000000000000000000000000000000000000000000000000000000000000000000000000000000000009
0000000000000000000000000000000000000000000000000000000000000000000000000000000000000000000000000000000000000311111000000000000000000000000000000000000000000000000000000000000000000000000000000000000000000000000000000000009
0000000000000000000000000000000000000000000000000000000000000000000000000000000000000000000000000000000000000311111000000000000000000000000000000000000000000000000000000000000000000000000000000000000000000000000000000000009
0000000000000000000000000000000000000000002111111111111111111111100000000000000000000000000000000000000000000000000000000000000000000000000000000000000000000000000000211111111111111111111110000000000000000000000000000000009
0000000000000000000000000000000000000000003111111111111111111111100000000000000000000000000000000000000000000000000000000000000000000000000000000000000000000000000000311111111111111111111110000000000000000000000000000000009
0000000000000000000000000000000000000000003111111111111111111111100000000000000000000000000000000000000000000000000000000000000000000000000000000000000000000000000000311111111111111111111110000000000000000000000000000000009
00000000000000000000000000000000000000000000000cccccc0000002111110000000000000000000000000000000000000000000000000000000000000000000000000000000000000000000000000000021111100000aaaaaa0000000000000000000000000000000000000009
00000000000000000000000000000000000000000000000cccccc0000003111110000000000000000000000000000000000000000000000000000000000000000000000000000000000000000000000000000031111100000aaaaaa0000000000000000000000000000000000000009
00000000000000000000000000000000000000000000000cccccc0000003111110000000000000000000000000000000000000000000000000000000000000000000000000000000000000000000000000000031111100000aaaaaa0000000000000000000000000000000000000009
00000000000000000000000000000000000000000000000cccccc0000003111110000000000000000000000000000000000000000000211111110000000000000000000000000000000000000000000000000031111100000aaaaaa0000000000000000000000000000000000000009
0000000000000000000000000000000000000000000000000000000000031111100000000000000000000000000000000000000000003111111100000000000000000000000000000000000000000000000000311111000000000000000000000000000000000000000000000000009
0000000000000000000000000000000000000000000000000000000000031111100000000000000000000000000000000000000000003111111100000000000000000000000000000000000000000000000000311111000000000000000000000000000000000000000000000000009
0000000000000000000000000000000000000000000000000000000000000000000000000000000000000000000000000000000000003111111100000000000000000000000000000000000000000000000000000000000000000000000000000000000000000000000000000000009
0000000000000000000000000000000000000000000000000000000000000000000000000000000000000000000000000000000000003111111100000000000000000000000000000000000000000000000000000000000000000000000000000000000000000000000000000000009
0000000000000000000000000000000000000000000000000000000000000000000000000000000000000000000000000000000000003111111100000000000000000000000000000000000000000000000000000000000000000000000000000000000000000000000000000000009
0000000000000000000000000000000000000000000000000000000000000000000000000000000000000000000000000000000000003111111100000000000000000000000000000000000000000000000000000000000000000000000000000000000000000000000000000000009
9999999999999999999999999999999999999999999999999999999999999999999999999999999999999999999999999999999999999999999999999999999999999999999999999999999999999999999999999999999999999999999999999999999999999999999999999999999